..........................
..........................
..##..##..##..##..##..##..
..##..##..##..##..##..##..
..##..##..##..##..##..##..
..##..##..##..##..##..##..
..##..##..##@@##..##..##..
..##..##..##@@##..##..##..
..##..##..##..##..##..##..
..##..##..........##..##..
..##..##..........##..##..
..........##..##..........
..........##..##..........
##..####..........####..##
@@..####..........####..@@
..........##..##..........
..........######..........
..##..##LL######..##..##..
..##..##LL##..##..##..##..
..##..##..##..##..##..##..
..##..##..##..##..##..##..
..##..##..........##..##..
..##..##..........##..##..
..##..##...####...##..##..
.........H.#..#...........
...........#..#...........