E.......##..E...##......E.
........##......##........
..%%%%%%##................
..%%%%%%##..........@@@@@@
##%%%%%%..................
##%%%%%%..................
%%%%%%%%......##..#######.
%%%%%%%%......##..#######.
%%%%%%%%########..##...#..
%%%%%%%%######....##...#..
%%%%%%%%....##.........#..
%%%%%%%%....##.........#..
..%%........@@@@@@....%%..
..%%........@@@@@@....%%..
..................%%%%%%%%
..##..##..........%%%%%%%%
###..####..#######%%%%%%%%
###..####..#......%%%%%%%%
..........##......%%%%%%%%
..........##..####%%%%%%%%
##....@...........%%%%%%..
##....@...........%%%%%%..
####..@...........%%%%%%..
####..@....####...%%%%%%..
@@####..H..#..#...##......
@@####.....#..#...##......